100000000000000000000000000000000000000000000000000000000000000000000000000000000000000000000000000000000000000000000000000000000000000000000000000000000000000000000000000000000000000000000000000000000000000000000000000000000000000000000000000000000000
100000000000000000000000000000000000000000000000000000000000000000000000000000000000000000000000000000000000000000000000000000000000000000000000000000000000000000000000000000000000000000000000000000000000000000000000000000000000000000000000000000000000
100000000000000000000000000000000000000000000000000000000000000000000000000000000000000000000000000000000000000000000000000000000000000000000000000000000000000000000000000000000000000000000000000000000000000000000000000000000000000000000000000000000000
10000000000000000000000000p00000000000000000000000000000000000000000000000000000000000222222220002222p00000000000000000000p00000000000000022220000002222000000000000000000000000000000000000000000000000000000000000000000000000000h000000000000000000000000
10000000000000000000000000000000000000000000000000000000000000000000000000000000000000000000000000000000000000000000000000000000000000000000000000000000000000000000000000000000000000000000000000000000000000000000000000000000000i000000000000000000000000
10000000000000000000000000000000000000000000000000000000000000000000000000000000000000000000000000000000000000000000000000000000000000000000000000000000000000000000000000000000000000000000000000000000000000000000000000033000000i000000000000000000000000
10000000000000000000000000000000000000000000000000000000000000000000000000000000000000000000000000000000000000000000000000000000000000000000000000000000000000000000000000000000000000000000000000000000000000000000000000333000000i00000jjj0000000000000000
1000000000000000000020002p2p200000000000000000000000de00000000de00000000000000000002p2000000000000000200000002220000000p00p00p00000000020000000000000220000000000003003000000000000003300330000000000002222200000000000003333000000i00000k2l0000000000000000
100000000000000000000000000000000000000000de00000000gf00000000gf0000000000000000000000000000000000000000000000000000000000000000000000000000000000000000000000000033003300000000000033300333000000000000000000000000000033333000000i0000jmmmj000000000000000
10000000000000000000000000000000de00000000gf00000000gf00000000gf0000000000000000000000000000000000000000000000000000000000000000000000000000000000000000000000000333003330000000000333300333300000de0000000000000000de0333333000000i000022n22000000000000000
10000000000000000000000000000000gf00000000gf00000000gf00000000gf0000000000000000000000000000000000000000000000000000000000000000000000000000000000000000000000003333003333000000003333300333330000gf0000000000000000gf33333330000003000022o22000000000000000
111111111111111111111111111111111111111111111111111111111111111111111111000111111111111111110000111111111111111111111111111111111111111111111111111111111111111111111111111111111111111001111111111111111111111111111111111111111111111111111111111111111111
///
11 25 0 1
11 47 0 1
11 49 0 1
3 86 0 1
3 89 0 1
11 100 0 1
11 103 0 1
11 115 0 1
11 125 0 1
11 127 0 1
11 150 0 1
11 152 0 1
11 203 0 1
11 205 0 1
///
2 1 0
///
11 5
///
400
