700000000000000000000000007
700000000000000000000000007
700000000000000000000000007
700000000000000000000000007
700000000000000000000000007
700000070000000000000000007
700000077770000000000000007
700000000000000000700000007
700000000000012300700000007
122222222222255522222223013
