100000000000000000000000001
100000000000000000000000001
100000000000000000000000001
100000000000000000000000001
100000000000000000000000001
100000000000000000000000001
100000020000200000000000001
100000022222200000000000001
100000000000000000100000001
100000000000011100000000001
111111111111111111111111011
///
4 15 1 1
6 9 1 1
///
1 11 1
///
9 1
///
400
